"a" = (/turf/unsimulated/mineral,/area/relay/relay_outside)
"b" = (/turf/unsimulated/mask,/area/mine/unexplored)
"c" = (/turf/simulated/floor/relay/grass,/area/relay/relay_outside)
"d" = (/turf/simulated/floor/tiled,/area/relay/relay_outside)
"e" = (/turf/simulated/wall,/area/relay/relay_outside)
"f" = (/obj/effect/wingrille_spawn/reinforced,/turf/simulated/floor/plating,/area/relay/relay_outside)
"g" = (/obj/machinery/door/airlock/glass_virology{name = "Relay Station Entrance"},/turf/simulated/floor/tiled,/area/relay/relay_outside)
"h" = (/turf/simulated/floor/plating,/area/relay/relay_outside)
"i" = (/obj/structure/sign/relay,/turf/simulated/wall,/area/relay/relay_outside)
"j" = (/obj/effect/overmap/sector/relay,/turf/simulated/floor/relay/grass,/area/relay/relay_outside)
"k" = (/turf/simulated/wall,/area/relay/shuttle_storage_room)
"l" = (/obj/structure/closet/secure_closet/decktech,/turf/simulated/floor/tiled,/area/relay/shuttle_storage_room)
"m" = (/turf/simulated/floor/tiled,/area/relay/shuttle_storage_room)
"n" = (/obj/structure/table/rack,/obj/item/clothing/suit/storage/hazardvest/white,/obj/item/clothing/suit/storage/hazardvest/green,/obj/item/clothing/suit/storage/hazardvest/blue,/obj/item/device/flashlight,/turf/simulated/floor/tiled,/area/relay/shuttle_storage_room)
"o" = (/turf/simulated/floor/plating,/area/relay/shuttle_storage_room)
"p" = (/obj/effect/floor_decal/industrial/warning{dir = 9},/turf/simulated/floor/plating,/area/relay/relay_outside)
"q" = (/obj/effect/floor_decal/industrial/warning{dir = 1},/turf/simulated/floor/plating,/area/relay/relay_outside)
"r" = (/obj/effect/floor_decal/industrial/warning{dir = 5},/turf/simulated/floor/plating,/area/relay/relay_outside)
"s" = (/obj/effect/floor_decal/industrial/warning{icon_state = "warning"; dir = 8},/turf/simulated/floor/plating,/area/relay/relay_outside)
"t" = (/obj/effect/floor_decal/industrial/hatch/yellow,/turf/simulated/floor/plating,/area/relay/relay_outside)
"u" = (/obj/effect/floor_decal/industrial/warning{dir = 4},/turf/simulated/floor/plating,/area/relay/relay_outside)
"v" = (/obj/effect/floor_decal/industrial/hatch/orange,/turf/simulated/floor/plating,/area/relay/relay_outside)
"w" = (/turf/simulated/floor/plating{icon_state = "dmg1"},/area/relay/relay_outside)
"x" = (/obj/effect/floor_decal/industrial/hatch/red,/turf/simulated/floor/plating,/area/relay/relay_outside)
"y" = (/obj/effect/floor_decal/industrial/warning{dir = 10},/turf/simulated/floor/plating,/area/relay/relay_outside)
"z" = (/obj/effect/floor_decal/industrial/warning,/turf/simulated/floor/plating,/area/relay/relay_outside)
"A" = (/obj/effect/floor_decal/industrial/warning{icon_state = "warning"; dir = 6},/turf/simulated/floor/plating,/area/relay/relay_outside)
"B" = (/turf/simulated/floor/plating{icon_state = "dmg4"},/area/relay/relay_outside)
"C" = (/turf/simulated/floor/plating{icon_state = "dmg2"},/area/relay/relay_outside)
"D" = (/turf/simulated/floor/plating{icon_state = "dmg3"},/area/relay/relay_outside)
"E" = (/obj/effect/floor_decal/industrial/warning,/turf/simulated/floor/plating{icon_state = "dmg4"},/area/relay/relay_outside)

(1,1,1) = {"
aaaaaaaaaaaaaaaaaaaaaaaaaaaaaaaaaaaaaaaaaaaaaaaaaaaaaaaaaaaaaaaaaaaaaaaaaaaaaaaaaaaaaaaaaaaaaaaaaaaa
abbbbbbbbbbbbbbbbbbbbbbbbbbbbbbbbbbbbbbbbbbbbbbbbbbbbbbbbbbbbbbbbbbbbbbbbbbbbbbbbbbbbbbbbbbbbbbbbbba
abbbbbbbbbbbbbbbbbbbbbbbbbbbbbbbbbbbbbbbbbbbbbbbbbbbbbbbbbbbbbbbbbbbbbbbbbbbbbbbbbbbbbbbbbbbbbbbbbba
abbbbbbbbbbbbbbbbbbbbbbbbbbbbbbbbbbbbbbbbbbbbbbbbbbbbbbbbbbbbbbbbbbbbbbbbbbbbbbbbbbbbbbbbbbbbbbbbbba
abbbbbbbbbbbbbbbbbbbbbbbbbbbbbbbbbbbbbbbbbbbbbbbbbbbbbbbbbbbbbbbbbbbbbbbbbbbbbbbbbbbbbbbbbbbbbbbbbba
abbbbbbbbbbbbbbbbbbbbbbbbbbbbbbbbbbbbbbbbbbbbbbbbbbbbbbbbbbbbbbbbbbbbbbbbbbbbbbbbbbbbbbbbbbbbbbbbbba
abbbbbbbbbbbbbbbbbbbbbbbbbbbbbbbbbbbbbbbbbbbbbbbbbbbbbbbbbbbbbbbbbbbbbbbbbbbbbbbbbbbbbbbbbbbbbbbbbba
abbbbbbbbbbbbbbbbbbbbbbbbbbbbbbbbbbbbbbbbbbbbbbbbbbbbbbbbbbbbbbbbbbbbbbbbbbbbbbbbbbbbbbbbbbbbbbbbbba
abbbbbbbbbbbbbbbbbbbbbbbbbbbbbbbbbbbbbbbbbbbbbcbbbbcccccccccccccccccbbbbbbbbbbbbbbbbbbbbbbbbbbbbbbba
abbbbbbbbbbbbbbbbbbbbbbbbbbbbbbbbbbbbbbbbcccccccccccccccccccccccccccccccccbbbbbbbbbbbbbbbbbbbbbbbbba
abbbbbbbbbbbbbbbbbbbbbbbbbbbbbbbbbbbbcccccccccccccccccccccccccccccccccccccccccccbbbbbbbbbbbbbbbbbbba
abbbbbbbbbbbbbbbbbbbbbbbbbbbbbbbbbcccccccccccccccccccccccccccccccccccccccccccccccccbbbbbbbbbbbbbbbba
abbbbbbbbbbbbbbbbbbbbbbbbbbbbbcccccccccccccccccccccccccccccccccccccccccccccccccccccccbbbbbbbbbbbbbba
abbbbbbbbbbbbbbbbbbbbbbbcccccccccccccccccccccccccccccccccccccccccccccccccccccccccccccbbbbbbbbbbbbbba
abbbbbbbbbbbbbbbbbccccccccccccccccccccccccccccccccccccccccccccccccccccccccccccccccccccbbbbbbbbbbbbba
abbbbbbbbbbbbbbbbcccccccccccccccccccccccccccccccccccccccccccccccccccccccccccccccccccccbbbbbbbbbbbbba
abbbbbbbbbbbbbbbbcccccccccccccccccccccccccccccccccccccccccccccccccccccccccccccccccccccbbbbbbbbbbbbba
abbbbbbbbbbbbbbbcccccccccccccccccccccccccccccccccccccccccccccccccccccccccccccccccccccccbbbbbbbbbbbba
abbbbbbbbbbbbbbccccccccccccccccccccccccccccccccccccccccccccccccccccccccccccccccccccccccbbbbbbbbbbbba
abbbbbbbbbbbbbbccccccccccccccccccccccccccccccccccccccccccccccccccccccccccccccccccccccccbbbbbbbbbbbba
abbbbbbbbbbbbbccccccccccccccccccccccccccccccccccccccccccccccccccccccccccccccccccccccccccbbbbbbbbbbba
abbbbbbbbbbbbbccccccccccccccccccccccccccccccccccccccccccccccccccccccccccccccccccccccccccbbbbbbbbbbba
abbbbbbbbbbbbbccccccccccccccccccccccccccccccccccccccccccccccccccccccccccccccccccccccccccbbbbbbbbbbba
abbbbbbbbbbbbcccccccccccccccccccccccccccccccccccccccccccccccccccccccccccccccccccccccccccbbbbbbbbbbba
abbbbbbbbbbbcccccccccccccccccccccccccccccccccccccccccccccccccccccccccccccccccccccccccccccbbbbbbbbbba
abbbbbbbbbbccccccccccccccccccccccccccccccccccccccccccccccccccccccccccccccccccccccccccccccbbbbbbbbbba
abbbbbbbbbbccccccccccccccccccccccccccccccccccccccccccccccccccccccccccccccccccccccccccccccbbbbbbbbbba
abbbbbbbbbbcccccccccccccccccccccccccccccccccccccccccccccccccccccccccccccccccccccccccccccccbbbbbbbbba
abbbbbbbbbccccccccccccccccccccccccccccccccccccccccccccccccccccccccccccccccccccccccccccccccbbbbbbbbba
abbbbbbbbbccccccccccccccccccccccccccccccccccccccccccccccccccccccccccccccccccccccccccccccccbbbbbbbbba
abbbbbbbbbccccccccccccccccccccccccccccccccccccccccccccccccccccccccccccccccccccccccccccccccbbbbbbbbba
abbbbbbbbbccccccccccccccccccccccccccccccccccccccccccccccccccccccccccccccccccccccccccccccccbbbbbbbbba
abbbbbbbbbbccccccccccccccccccccccccccccccccccccccccccccccccccccccccccccccccccccccccccccccccbbbbbbbba
abbbbbbbbbbbcccccccccccccccccccccccccccccccccccccccccccccccccccccccccccccccccccccccccccccccbbbbbbbba
abbbbbbbbbbccccccccccccccccccccccccccccccccccccccccccccccccccccccccccccccccccccccccccccccccbbbbbbbba
abbbbbbbbbbccccccccccccccccccccccccccccccccccccccccccccccccccccccccccccccccccccccccccccccccbbbbbbbba
abbbbbbbbbcccccccccccccccccccccccccccccccccccccccccccccccccccccccccccccccccccccccccccccccccbbbbbbbba
abbbbbbbbbccccccccccccccccccccccccccccccccccccccccccccccccccccccccccccccccccccccccccccccccbbbbbbbbba
abbbbbbbbbccccccccccccccccccccccccccccccccccccccddddddddddccccccccccccccccccccccccccccccccbbbbbbbbba
abbbbbbbbcccccccccccccccccccccccccccccccccccccccddddddddddccccccccccccccccccccccccccccccccbbbbbbbbba
abbbbbbbbcccccccccccccccccccccccccccccccccccccccddddddddddccccccccccccccccccccccccccccccccbbbbbbbbba
abbbbbbbbcccccccccccccccccccccccccccccccccccccccddddddddddccccccccccccccccccccccccccccccccbbbbbbbbba
abbbbbbbbccccccccccccccccccccccccccccccccccccccceeefggfeeeccccccccccccccccccccccccccccccccbbbbbbbbba
abbbbbbbbccccccccccccccccccccccccccccccccccccccccccchhccccccccccccccccccccccccccccccccccccbbbbbbbbba
abbbbbbbbccccccccccccccccccccccccccccccccccccccccccchhccccccccccccccccccccccccccccccccccccbbbbbbbbba
abbbbbbbcccccccccccccccccccccccccccccccccccccccccccchhccccccccccccccccccccccccccccccccccccbbbbbbbbba
abbbbbbbcccccccccccccccccccccccccccccccccccccccccccchhccccccccccccccccccccccccccccccccccccbbbbbbbbba
abbbbbbbcccccccccccccccccccccccccccccccccccccccccccchhcicccccccccccccccccccccccccccccccccbbbbbbbbbba
abbbbbbbcccccccccccccccccccccccccccccccccccccccccccchhcccccccccccccccccccccccccccccccccccbbbbbbbbbba
abbbbbbbcccccccccccccccccccccccccccccccccccccccccccchhcccccccccccccccccccccccccccccccccccbbbbbbbbbba
abbbbbbbcccccccccccccccccccccccccccccccccccccccccjcchhcccccccccccccccccccccccccccccccccccbbbbbbbbbba
abbbbbbbbccccccccccccccccccccccccccccccccccccccccccchhcccccccccccccccccccccckkkkkkcccccccbbbbbbbbbba
abbbbbbbbccccccccccccccccccccccccccccccccccccccccccchhccccccccccccccccccccccklmmnkcccccccbbbbbbbbbba
abbbbbbbbccccccccccccccccccccccccccccccccccccccccccchhcccccccccccccccccccccckmmmmkcccccccbbbbbbbbbba
abbbbbbbbccccccccccccccccccccccccccccccccccccccccccchhcccccccccccccccccccccckkookkcccccccbbbbbbbbbba
abbbbbbbbccccccccccccccccccccccccccccccccccccccccccchhcccccccccccccccccccccccchhcccccccccbbbbbbbbbba
abbbbbbbbccccccccccccccccccccccccccccccccccccccccccchhhhhhhhhhhhhhhhhhhhhhhhhhhhhhhcccccccbbbbbbbbba
abbbbbbbbccccccccccccccccccccccccccccccccccccccccccchhhhhhhhhhhhhhhhhhhhhhhhhhhhhhhccccccccbbbbbbbba
abbbbbbbbccccccccccccccccccccccccccccccccccccccccccchhcccccchhccccccccccccccccccchhccccccccbbbbbbbba
abbbbbbbbcccccccccccccccccccccccccccccpqqqqqqqqqqqqqqqrccccpqqqqqqqqqqqqqqqrccccpqqqqqrccccbbbbbbbba
abbbbbbbbbccccccccccccccccccccccccccccshhhhhhhthhhhhhhuccccshhhhhhhthhhhhhhuccccshhhhhuccccbbbbbbbba
abbbbbbbbbccccccccccccccccccccccccccccshhhhhhhthhhhhhhuccccshhhhhhhthhhhhhhuccccshhhhhuccccbbbbbbbba
abbbbbbbbbccccccccccccccccccccccccccccshhhhhhhthhhhhhhuccccshhhhhhhthhhhhhhuccccshhhhhuccccbbbbbbbba
abbbbbbbbbccccccccccccccccccccccccccccshhhhhhhthhhhhhhuccccshhhhhhhthhhhhhhuccccshhhhhuccccbbbbbbbba
abbbbbbbbbccccccccccccccccccccccccccccshhhhhhhthhhhhhhuccccshhhhhhhthhhhhhhuccccshhhhhuccccbbbbbbbba
abbbbbbbbbccccccccccccccccccccccccccccshhhhhhhthhhhhhhuccccshhhhhhhthhhhhhhuccccshhhhhuccccbbbbbbbba
abbbbbbbbbbcccccccccccccccccccccccccccshhhhhhhvhhhhhhhuccccshhhhhhhvhhhhhhhuccccshhhhhuccccbbbbbbbba
abbbbbbbbbbcccccccccccccccccccccccccccshhhhhhhvhhhhhhhuccccshhhhhhhvhhhhhhhuccccswhhhhuccccbbbbbbbba
abbbbbbbbbbcccccccccccccccccccccccccccshhhhhhhvhhhhhhhuccccshhhhhhhvhhhhhhhuccccshhhwhuccccbbbbbbbba
abbbbbbbbbbcccccccccccccccccccccccccccshhhhhhhxhhhhhhhuccccshhhhhhhxhhhhhhhuccccyzzzzzAcccbbbbbbbbba
abbbbbbbbbbcccccccccccccccccccccccccccstttvvvxxxvvvtttuccccstttvvvxxxvvvtttuccccccccccccccbbbbbbbbba
abbbbbbbbbbcccccccccccccccccccccccccccshhhhhhhxhhhhhhhuccccshhhhhhhxhhhhhhhuccccccccccccccbbbbbbbbba
abbbbbbbbbbcccccccccccccccccccccccccccshhhhhhhvhhhhhhhuccccshhhhhhhvhhhhhhhucccccccccccccbbbbbbbbbba
abbbbbbbbbbbccccccccccccccccccccccccccshhhhhhhvhhhhhhhuccccshhhhhhhvhhhhhhhuccccccccccccbbbbbbbbbbba
abbbbbbbbbbbccccccccccccccccccccccccccshhhhhhhvhhhhhhhuccccshhhhhhhvhhhhhhhuccccccccccccbbbbbbbbbbba
abbbbbbbbbbbccccccccccccccccccccccccccshhhhhhhthhhhhhhuccccshhhhhhhthhhhhhhuccccccccccbbbbbbbbbbbbba
abbbbbbbbbbbccccccccccccccccccccccccccshhhhhhhthhhhhhhuccccshhhhhhhthhhhhhhuccccccccccbbbbbbbbbbbbba
abbbbbbbbbbbccccccccccccccccccccccccccshhhhhhhthhhhhhhuccccshhhhhhhthhhhhhhucccccccccbbbbbbbbbbbbbba
abbbbbbbbbbbbcccccccccccccccccccccccccshhhhhhhthhhhhhhuccccshhhhhhhthhhhhhhucccccccccbbbbbbbbbbbbbba
abbbbbbbbbbbbcccccccccccccccccccccccccshhhhhhhthhhhhhhuccccshhhhhhhthhhhhhhucccccccccbbbbbbbbbbbbbba
abbbbbbbbbbbbcccccccccccccccccccccccccshhhhBhhthhhChhBuccccshhhBhhhthhwhhwhucccccccccbbbbbbbbbbbbbba
abbbbbbbbbbbbbccccccccccccccccccccccccswDhBhChthwhhwhhuccccshBwhChDthChBhhhuccccccccbbbbbbbbbbbbbbba
abbbbbbbbbbbbbccccccccccccccccccccccccyzzzzzzzzzzzzzzzAccccyzzzzzzzzzzzzzzEAccccccccbbbbbbbbbbbbbbba
abbbbbbbbbbbbbbcccccccccccccccccccccccccccccccccccccccccccccccccccccccccccccccccccccbbbbbbbbbbbbbbba
abbbbbbbbbbbbbbccccccccccccccccccccccccccccccccccccccccccccccccccccccccccccccccccccbbbbbbbbbbbbbbbba
abbbbbbbbbbbbbbbccccccccccccccccccccccccccccccccccccccccccccccccccccccccccccccccccbbbbbbbbbbbbbbbbba
abbbbbbbbbbbbbbbbbbbcccccccccccccccccccccccccccccccccccccccccccccccccccccccccccbbbbbbbbbbbbbbbbbbbba
abbbbbbbbbbbbbbbbbbbbbcccccccccccccccccccccccccccccccccccccccccccccccccccccccbbbbbbbbbbbbbbbbbbbbbba
abbbbbbbbbbbbbbbbbbbbbbbbccccccccccccccccccccccccccccccccccccccccccccccccccbbbbbbbbbbbbbbbbbbbbbbbba
abbbbbbbbbbbbbbbbbbbbbbbbbbbbbcccccccccccccccccccccccccccccccccccccbbbbbbbbbbbbbbbbbbbbbbbbbbbbbbbba
abbbbbbbbbbbbbbbbbbbbbbbbbbbbbbbbcccccccccccccccccccccccccccccbbbbbbbbbbbbbbbbbbbbbbbbbbbbbbbbbbbbba
abbbbbbbbbbbbbbbbbbbbbbbbbbbbbbbbbbbbbbbbbbccccccccccccccccbbbbbbbbbbbbbbbbbbbbbbbbbbbbbbbbbbbbbbbba
abbbbbbbbbbbbbbbbbbbbbbbbbbbbbbbbbbbbbbbbbbbbbbbbbbbbbbbbbbbbbbbbbbbbbbbbbbbbbbbbbbbbbbbbbbbbbbbbbba
abbbbbbbbbbbbbbbbbbbbbbbbbbbbbbbbbbbbbbbbbbbbbbbbbbbbbbbbbbbbbbbbbbbbbbbbbbbbbbbbbbbbbbbbbbbbbbbbbba
abbbbbbbbbbbbbbbbbbbbbbbbbbbbbbbbbbbbbbbbbbbbbbbbbbbbbbbbbbbbbbbbbbbbbbbbbbbbbbbbbbbbbbbbbbbbbbbbbba
abbbbbbbbbbbbbbbbbbbbbbbbbbbbbbbbbbbbbbbbbbbbbbbbbbbbbbbbbbbbbbbbbbbbbbbbbbbbbbbbbbbbbbbbbbbbbbbbbba
abbbbbbbbbbbbbbbbbbbbbbbbbbbbbbbbbbbbbbbbbbbbbbbbbbbbbbbbbbbbbbbbbbbbbbbbbbbbbbbbbbbbbbbbbbbbbbbbbba
abbbbbbbbbbbbbbbbbbbbbbbbbbbbbbbbbbbbbbbbbbbbbbbbbbbbbbbbbbbbbbbbbbbbbbbbbbbbbbbbbbbbbbbbbbbbbbbbbba
abbbbbbbbbbbbbbbbbbbbbbbbbbbbbbbbbbbbbbbbbbbbbbbbbbbbbbbbbbbbbbbbbbbbbbbbbbbbbbbbbbbbbbbbbbbbbbbbbba
aaaaaaaaaaaaaaaaaaaaaaaaaaaaaaaaaaaaaaaaaaaaaaaaaaaaaaaaaaaaaaaaaaaaaaaaaaaaaaaaaaaaaaaaaaaaaaaaaaaa
"}
